NO texture/wall_2.xpm
WE texture/wall_2.xpm
EA texture/wall_2.xpm
SO texture/wall_2.xpm
F 75,150,50
C 0,120,200

111111111111
100000000001
101110000001
101 10000001
101110000001
100000000001
101110000001
10111000N001
101110000001
100000000001
111111111111
