NO texture/wall_4.xpm
WE texture/wall_4.xpm
EA texture/wall_4.xpm
SO texture/wall_4.xpm
F 75,150,50
C 0,120,200

111111111
101000001
100100E01
100000011
111111111