NO texture/wall_1.xpm
WE texture/wall_2.xpm
EA texture/wall_3.xpm
SO texture/wall_4.xpm
F 75,150,50
C 0,120,200

11111111111111111111111111111
10000000001100000000000011111
10110000011100000000000011111
10010000000000000000000011111
11111111101100000111000001111
10000000001100000111011111111
11110111111111011100000010001
11110111111111011101010000001
11000000110101011100000010001
10000000000000000000000010001
10000000000000001101010010001
11000001110101011111011110N01
11110111 1110101 101111010001
11111111 1111111 111111111111